+--------------------------------------------------------+
|                                                        |
|                                                        |
|                                                        |
|                                                        |
|                                                        |
|                                                        |
|                                                        |
|                                                        |
|  S                                                     |
|XXXXXXXXXXXXXXXXXXXXXXXXXX>   <XXXXXXXXXXXXXXXXXXXXXXXXX|
|XXXXXXXXXXXXXXXXXXXXXXXXXX>   <XXXXXXXXXXXXXXXXXXXXXXXXX|
|XXXXXXXXXXXXXXXXXXXXXXXXXX>   <XXXXXXXXXXXXXXXXXXXXXXXXX|
|XXXXXXXXXXXXXXXXXXXXXXXXXX>   <XXXXXXXXXXXXXXXXXXXXXXXXX|
|XXXXXXXXXXXXXXXXXXXXXXXXXX>   <XXXXXXXXXXXXXXXXXXXXXXXXX|
|XXXXXXXXXXXXXXXXXXXXXXXXXX>   <XXXXXXXXXXXXXXXXXXXXXXXXX|
|XXXXXXXXXXXXXXXXXXXXXXXXXX>   <XXXXXXXXXXXXXXXXXXXXXXXXX|
|XXXXXXXXXXXXXXXXXXXXXXXXXX>   <XXXXXXXXXXXXXXXXXXXXXXXXX|
|XXXXXXXXXXXXXXXXXXXXXXXXXX>   <XXXXXXXXXXXXXXXXXXXXXXXXX|
|XXXXXXXXXXXXXXXXXXXXXXXXXX>   <XXXXXXXXXXXXXXXXXXXXXXXXX|
|XXXXXXXXXXXXXXXXXXXXXXXXXX>   <XXXXXXXXXXXXXXXXXXXXXXXXX|
|XXXXXXXXXXXXXXXXXXXXXXXXXX>   <XXXXXXXXXXXXXXXXXXXXXXXXX|
|XXXXXXXXXXXXXXXXXXXXXXXXXX>   <XXXXXXXXXXXXXXXXXXXXXXXXX|
|XXXXXXXXXXXXXXXXXXXXXXXXXX>   <XXXXXXXXXXXXXXXXXXXXXXXXX|
|XXXXXXXXXXXXXXXXXXXXXXXXXX>   <XXXXXXXXXXXXXXXXXXXXXXXXX|
|XXXXXXXXXXXXXXXXXXXXXXXXXX>   <XXXXXXXXXXXXXXXXXXXXXXXXX|
|XXXXXXXXXXXXXXXXXXXXXXXXXX>   <XXXXXXXXXXXXXXXXXXXXXXXXX|
|XXXXXXXXXXXXXXXXXXXXXXXXXX>   <XXXXXXXXXXXXXXXXXXXXXXXXX|
|XXXXXXXXXXXXXXXXXXXXXXXXXX>   <XXXXXXXXXXXXXXXXXXXXXXXXX|
|XXXXXXXXXXXXXXXXXXXXXXXXXX> O <XXXXXXXXXXXXXXXXXXXXXXXXX|
+--------------------------------------------------------+